11111111111000001111111111111111
00100100001111101000000000000001
00000100000000001000001111100001
11111111111111111000001000111111
01000100000001001000001000000001
01001100000001001001110000000001
01001000100001001000010000111111
01001111111101001111110000100000
01001000010001001000010000100000
01001000010000001000010000100000
11111111111111111111111111111111
00100000100000001000000100100000
00100000100010001000000100111111
11111111100010001111000100100100
01000000100010001001111110111111
01100000100010001000000000100000
00110000111111111111111111100000
00010000100000001000010000111110
00010000100000001000010000100000
11111111111111111111111111100001
01010000100001000000000000100001
01010000100001000000011111111101
01010000111111111100010000100001
01111000100100000010010000100001
01001000100100000011111111111111
01001111101111100000001000000001
01001000100000111111111100000001
01001111100000100001000111110001
11001000111111100001000000000001
01111000100000111111111111111111
11001111100000100000000100001000
10000000100000100000000100001000