00000000100001000000001000000111
00000000100001000011111111111101
00001111111111000010000001000111
11111000010001111110001001000010
10000000010001000000001011111111
11100000011111000001111010000010
00100000010000000001001010000010
00100000010000000101001111111110
11111111110000000101000000000000
00100000010000000101000000111111
00100000011111110101000000100010
00110000010000000111111111100011
00010000010000000100000000100000
11110000010000000101111110111000
00010000000000000100000010001000
00011111111111111111000010001000
11110000010000100001000010001001
00010000010000100001111110001001
00011111110000100001000000001111
00010000010000100001000000001000
00010000010000100001000000001000
11111111111111111111111111111000
00000100010000100001000000000000
00000100010000100001000000000000
11000100010000100001000011111111
01111100010000100001111110000001
11000100010000111110000000000001
10000000010000000000000000000001
11111111111111111111111111111111
00100000010000000001000100000100
00100000010000000001000100000111
11111111110000000001000100000000