00010010000001000001111111111111
00010111111111111101000000001001
00010000000001000001000000001001
11111111111111111111110000001001
00010100000001000100011111111111
00010100000001000100000000001000
00010111111101111111100010001000
00010000000001000000100011001000
11110000000001000000100010001000
00010000000001111000111110001111
00010000000011001100000000001000
00010000000110000110000000001000
11111111111100000011111111111111
00000000100110000110000100000001
00000000100011001100000100000001
00111111100001111000000100000001
00100000100000001000000111111101
00100000111111111000000000100101
11100000100000001111000000100101
10111111111100000001000000100101
10000000100111110001000000100101
11110000100000010001000001100111
00011100100111111111000001000000
00010111100000010001000001000000
00010010001111110001000001000000
11110011000000000001111111000000
10000001111111111111000000000000
11111100100000000001111111111111
00000100111111111111000000000001
11100110100010010001111111111101
10110010100010010001000100100101
10011111100010010001000100100111