00000100000000001111111111111111
11111100000000001000000100000001
10000111111111111111110100000001
10000100000000000000010111111111
11111111111111111000010001000000
00010100000000001000010001000000
00010100000000001000010001000000
11110111111111111111111111111110
00010000000000001000010001000010
00010000000000001000010001000010
00011111111111111111111111111010
00010001000000001000000001000010
11110001111000001000000001000010
00010000001100001000000001000010
00010000000100001000011111111111
11111111111100001000010001000001
00000000000100000000010001000001
00111100000111111111111111111111
00100110000100000000010000010000
00100011000100000000010000010000
00100001100100000000010000010000
11100000111111111111110000010000
00100000000000000000010000010000
00111111111111111110010000011111
00100000000100000010010000000000
00100000000100000011111111111111
11111110000111111010000000000001
00000010000000000010000000000001
00000011111111111110000000000001
11110010000000000011111111111101
10010011111111111110000000100001
10011110001000001000000000111111