00001000010000000111111111111111
00001000010000000100000000000000
11111000010000000100000000010100
00001000010000000100000000010100
00001000010000000100000000011111
00001000010000000100000000010000
11111111110000000100000000010000
00001000010000000100000000010000
00001000010000000100000000010000
00001000010000000100000000010000
00001000011111111111111111111111
00001000010000000000000000010000
00000000010000000000000000010000
11111111110111111111111111110000
00000000010000000000000000010000
00000000010000000000000000010000
00000000011111111111111111111111
00000000010000000001000000000000
11111111110000000001000000000000
00010000010000000001000000000000
00010000011111111111111111111111
11110000010000000001000000001000
00010000010000000001000000001000
00011111111111111111111111111111
00010000010000001000000010000001
00010000010000001000000010000001
00010000010000001000000010000001
11111110011111111111111111111111
00000010010000000000000010001001
11110010011111111111111110001001
10011110000000001000000010001001
11110000000000001000000010001001