11111100001000000100000000100001
00000100001000000100000000100001
00000100001111111111111111111111
11111111111000000100000000100000
00000000001000000111111111100000
00000000001000000100000000000000
11111111111111111111111111111111
10000000001000000100000000100100
10111111111000000100000000100100
10000000001000000100000000100111
11111111111111111100000000100000
10000000000000000100000000100000
10000000000000000100000000100000
11111111111111111100000000100000
10000000100000000100000000111111
10000000111111110100000000100000
10000000000000000100000000100000
11111111111111111111111111100000
00100000000000000100000000100000
00100000000000000100000000111111
00100000000000000100000000000001
00100000000000000100000000000001
00111111111111111111111111111111
00100000000000000100000000001000
00100000000000000100000000001000
00111111111111111100000000001000
00100000000000000101111111111111
00100000000000000100000000000000
11111111111111111111111111111111
10001000000000000100000010000001
10001000000000000100000010000001
11111111111111111100000011111101