00000100000100000010000010000001
00000100000100000010000010000001
00000100000100000010000011111111
11111111111111111111111110000000
00000100000000000000000010000000
11111111111111111100000010000000
00000100000000000111111111111111
00000100000000000100000000000010
11111111111111111100000000000010
00000000100000000111111111111110
00000000100000000100000000000000
11111111111111111111111111111111
00000010000000100000000000001000
00000010000000100000000000001000
00000010000000111111111111111000
00000010000000100000000000001000
11111111111111101111111111111111
00000000000000100000000000000000
11111111111111100000000000000000
00000010000000111111111111111111
00000010000000100000000100010000
11111111111111100000000100011111
00000010000000100000000100000100
00000010000000100000000100000100
00000010000000111111111100000100
11111111111111100000000000000100
00000010000000100000000000000100
00000010000000111111111111111111
00000010000000000000000100100001
11111111111111111111111100111111
10100000001000001000000100000001
11100000001000001000000101111111