00010000011111111111111111111111
00010000010000000000000100000001
00010000010000000000000100000001
00010000011111111111111111111111
00010000010000000000000000001000
00010000010000000000000000001000
11111111111111111111011111111000
10000000000000000001000000001111
11111111110000000001000000001000
00000000010000000001000000001000
00000000010000000001000000001000
00000000011111111111111111111111
00000000010000100001000001000000
11111111110000100001000001000000
00000000010000100001000001000000
00011111111111111111000001111111
00010000010000100001000001000000
11111111110000100001000001000000
00010000011111100001000001111111
00010000010000000001000001000000
00010000010000000001111111111111
00010000010000000001000000000000
11111111110000000001000000000000
00000000010000000001000000000000
00000000011111111111110000000000
11111111110000000000011111111111
10000000010000000000010000001000
10000000011111111111110000001000
10000000010000000000000000001000
11111111111111111111111111111000
10000000010000000000100000001000
10000000010000000000100000001111