00000111111111111111111111000001
00000100000000100000000001000001
11111100000000111111111111111111
00000100000000100000000001000000
00000100000000100000000001000000
11111111111111111111111111111111
00000100010000010001000001000000
00000100010000010001111101000000
00000100010111110001000001000000
00000100010000000001000001000000
11111111111111111111111111111111
00000100000000010000000001000000
00000100000000010000000001000000
11111100000000010000000001111111
00000100000000010000000001000100
00000111111111111111111111000100
00000000000000000000100000000100
11111111111111111111100000000000
00100000000000000000111111111111
00100111111111111111100000010000
00100100000000000000100000010000
00100100000000000000100000010000
11111111111111111111100000010000
00000100000000000000000000000000
00000111111111111111111111111111
00000100000000000000000000100000
00000111111111111111111111100000
00000100000000000100000000100000
00000100000000000100000000111111
11111100000000000100000000000001
10000111111111111111111111111111
10000100000000000000000000100000