00001000000000000000000000000001
00001111111111111111111111111111
11111000000000000000000000000001
00001000000000000000111111111111
00001111111111111110100000000001
00001000000000000000100000000001
11111111111000000000111111111111
10000000001000000000000000000001
10000000001000000000000000000001
11111111111111111111111111111111
00000000001000000000000000000001
11111111111111111111111111111111
10000000001000000000100000000000
11100000001000000000111111111111
00100000001000000000100000010000
00100000001000000000100000010000
00111111111111111111111111111111
00000000001000000000100000000000
00000000001000000000100000000000
11111111111111111111100000000000
00000000001000000000111111111111
00000000001000000000100000100000
00000000001000000000100000100000
11111111111111111111100000100000
10000100000000000000100000100000
10000100000000000000100000100000
10000111111111111111100000100000
10000100000010000000100000100000
10111100000010000000111111111111
10100000000010000000100000000000
10000000000010000000000000000000
11111111111111111111111111111111